1 1 1 1 1 1 1 1 1 1 1 1 1 1 1 1 1 1 1 1 1 1 1 1 1 1 1 1
1 3 3 3 3 3 3 3 3 3 3 3 3 1 1 3 3 3 3 3 3 3 3 3 3 3 3 1
1 3 1 1 1 1 3 1 1 1 1 1 3 1 1 3 1 1 1 1 1 3 1 1 1 1 3 1
1 6 1 0 0 1 3 1 0 0 0 1 3 1 1 3 1 0 0 0 1 3 1 0 0 1 6 1
1 3 1 1 1 1 3 1 1 1 1 1 3 1 1 3 1 1 1 1 1 3 1 1 1 1 3 1
1 3 3 3 3 3 3 3 3 3 3 3 3 3 3 3 3 3 3 3 3 3 3 3 3 3 3 1
1 3 1 1 1 1 3 1 1 3 1 1 1 1 1 1 1 1 3 1 1 3 1 1 1 1 3 1
1 3 1 1 1 1 3 1 1 3 1 1 1 1 1 1 1 1 3 1 1 3 1 1 1 1 3 1
1 3 3 3 3 3 3 1 1 3 3 3 3 1 1 3 3 3 3 1 1 3 3 3 3 3 3 1
1 1 1 1 1 1 3 1 1 1 1 1 3 1 1 3 1 1 1 1 1 3 1 1 1 1 1 1
0 0 0 0 0 1 3 1 1 1 1 1 3 1 1 3 1 1 1 1 1 3 1 0 0 0 0 0
0 0 0 0 0 1 3 1 1 3 3 3 3 3 3 3 3 3 3 1 1 3 1 0 0 0 0 0
0 0 0 0 0 1 3 1 1 3 1 1 1 4 4 1 1 1 3 1 1 3 1 0 0 0 0 0
1 1 1 1 1 1 3 1 1 3 1 0 0 0 0 0 0 1 3 1 1 3 1 1 1 1 1 1
2 0 0 0 0 0 3 3 3 3 1 0 0 0 0 0 0 1 3 3 3 3 0 0 0 0 0 2
1 1 1 1 1 1 3 1 1 3 1 0 0 0 0 0 0 1 3 1 1 3 1 1 1 1 1 1
0 0 0 0 0 1 3 1 1 3 1 1 1 1 1 1 1 1 3 1 1 3 1 0 0 0 0 0
0 0 0 0 0 1 3 1 1 3 3 3 3 3 3 3 3 3 3 1 1 3 1 0 0 0 0 0
0 0 0 0 0 1 3 1 1 3 1 1 1 1 1 1 1 1 3 1 1 3 1 0 0 0 0 0
1 1 1 1 1 1 3 1 1 3 1 1 1 1 1 1 1 1 3 1 1 3 1 1 1 1 1 1
1 3 3 3 3 3 3 3 3 3 3 3 3 1 1 3 3 3 3 3 3 3 3 3 3 3 3 1
1 3 1 1 1 1 3 1 1 1 1 1 3 1 1 3 1 1 1 1 1 3 1 1 1 1 3 1
1 3 1 1 1 1 3 1 1 1 1 1 3 1 1 3 1 1 1 1 1 3 1 1 1 1 3 1
1 6 3 3 1 1 3 3 3 3 3 3 3 3 5 3 3 3 3 3 3 3 1 1 3 3 6 1
1 1 1 3 1 1 3 1 1 3 1 1 1 1 1 1 1 1 3 1 1 3 1 1 3 1 1 1
1 1 1 3 1 1 3 1 1 3 1 1 1 1 1 1 1 1 3 1 1 3 1 1 3 1 1 1
1 3 3 3 3 3 3 1 1 3 3 3 3 1 1 3 3 3 3 1 1 3 3 3 3 3 3 1
1 3 1 1 1 1 1 1 1 1 1 1 3 1 1 3 1 1 1 1 1 1 1 1 1 1 3 1
1 3 1 1 1 1 1 1 1 1 1 1 3 1 1 3 1 1 1 1 1 1 1 1 1 1 3 1
1 3 3 3 3 3 3 3 3 3 3 3 3 3 3 3 3 3 3 3 3 3 3 3 3 3 3 1
1 1 1 1 1 1 1 1 1 1 1 1 1 1 1 1 1 1 1 1 1 1 1 1 1 1 1 1
